+++++++++++++++++++++
+     +     +     + +
+ +++ + +++ + +++ + +
+S+     +   +   +   +
+++ +++ + + + + + +++
+     +   + + + +   +
+ +++ +++++ + +++ + +
+ +       + +   + + +
+ +++++++ + +++ + + +
+ +     +       +   +
+ + + +++++++++ + +++
+ + +         +   + +
+ +++++++ + +++ + + +
+   +   + + +   +   +
+++ +++ + + + +++ + +
+       +   +     + +
+++++++++++++++++++ +