++++++++++++++++++++++
+   +   ++ ++        +
      +     ++++++++++
+ +    ++  ++++ +++ ++
+ +   + + ++    +++  +
+          ++      + +
+++++ + +      ++  + +
+++++ +++  + +  ++   +
+          + +  + + S+
+++++ +  + + +     + +
++++++++++++++++++++++